BR : Beetle Races
Core : Core Game
    CL : Crafting List
    PSNA: Pact Supply Network Agent
Collections : Collection
F : Festivals
    DB : Dragon Bash
    FW : Four Winds
    H : Halloween
    LNY : Lunar New Year
    SAB : Super Adventure Box
    W : Windersday
GM : Guild Missions
    GR : Guild Races
GN : Gathering Nodes
HoT : Heart of Thorns
JP : Jumping Puzzles
LWS2 : Living World Season 2
    DT : Dry Top
    SW : Silverwastes
LWS3 : Living World Season 3
    BFF : Bitterfrost Frontier
    BSF : Bloodstone Fen
    DM : Draconis Mons
    EB : Ember Bay
    LD : Lake Doric
    SL : Sirens Landing
LWS4 : Living World Season 4
    DoI : Domain of Istan
    DoK : Domain of Kourna
    DF : Dragonfall
    JB : Jahai Bluffs
    SI : Sandswept Isles
    TP : Thunderhead Peaks
LWS5 : Living World Season 5
    BM : Bjora Marches
    DC : Drizzlewood Coast
    GV : Grothmar Valley
MC : Map Completion
PoF : Path of Fire
    CO : Crystal Oasis
    DH : Desert Highlands
    DoV : Domain of Vabbi
    ER : Elon Riverlands
    TD : The Desolation
